####################
#                  #
#                  #
#  ######  ######  #
#  ######+ ######  #
#          +       #
#       +          #
#  ###### +######  #
#  ######  ######  #
#                  #
#                  #
####################
