#######################################################################
#                                                                     #
#                                                                     #
#  #######################  ###################  #################### #
#  #######################  ###################  #################### #
#  #######################  ###################  #################### #
#  #######################+ ###################+ #################### #
#                           +                    +                    #
#                        +                    +                       #
#  ####################### +################### +#################### #
#  #######################  ###################  #################### #
#  #######################  ###################+ #################### #
#  #######################                       #################### #
#  #######################                    +  #################### #
#  ############################################ +#################### #
#  ############################################  #################### #
#  ############################################+ #################### #
#                                                                     #
#                                             +                       #
#  ####################################################  ############ #
#  ####################################################  ############ #
#  ########                                       #####  ############ #
#  ########                                       #####  ############ #
#  ########  ###################################  #####  ############ #
#  ########  ###################################  #####  ############ #
#  ########  ###################################  #####  ############ #
#                                                                     #
#                                                                     #
#######################################################################
