########################################################################
#                                                                      #
#                                                                      #
#  #######################  ###################  ####################  #
#  #######################  ###################  ####################  #
#  #######################  ###################  ####################  #
#  #######################+ ###################+ ####################  #
#             +             +                    +                     #
#          +             +                    +                        #
#  ######### +############ +################### +####################  #
#  #########  ############  ###################  ####################  #
#  #########  ############  ###################  ####################  #
#  #########                                     ####################  #
#  #########                                     ####################  #
#  #########  #################################  ####################  #
#  #########  #################################  ####################  #
#  #########+ #################################+ ####################  #
#             +                               +          +             #
#          +                                     +    +                #
#  #################################################### +############  #
#  ####################################################  ############  #
#  ########                                       #####  ############  #
#  ########                                       #####  ############  #
#  ########  ###################################  #####  ############  #
#  ########  ###################################  #####  ############  #
#  ########  ###################################  #####  ############  #
#                                                                      #
#                                                                      #
########################################################################
