--------------------------------------
....+..........+............+.........
.+..........+............+............
--.+---------.+-----------.+----------
--..---------..-----------..----------
--..---------..-----------..----------
--..---------..-----------..----------
--..---------..-----------..----------
--+.---------+.-----------+.----------
....+..........+............+.........
.+.......................+........+...
--.+----------------------.+-------.+-
--..----------------------..-------..-
--..----------------------..-------..-
--..----------------------..-------..-
--+.----------------------+.-------..-
....+.......................+........-
.+.......................+...........-
--.+----------------------.+----------
--..----------------------..----------
--..........................----------
--..........................----------
--------------------------------------