###############################################################################################################################
#                                                            +                                                                #
#                                                            +                                                                #
#  #########################################################################################################################  #
#                                                            +                                                                #
#                                                            +                                                                #
###############################################################################################################################
