####################
#          #       #
#          #       #
#  ######  ######  #
#  ######+ ######  #
#          +       #
#      +           #
#  ###### +######  #
#  ######  ######  #
#                  #
#                  #
####################
