---------------------
--         ----------
--         ----------
---------  ----------
---------+ ----------
-          +        -
-       +           -
--------- +----------
---------  ----------
--         ----------
--         ----------
---------------------
