▇▇▇▇▇▇▇▇▇▇▇▇▇▇▇▇▇▇▇▇
▇                  ▇
▇                  ▇
▇  ▇▇▇▇▇▇  ▇▇▇▇▇▇  ▇
▇  ▇▇▇▇▇▇+ ▇▇▇▇▇▇  ▇
▇          +       ▇
▇      +           ▇
▇  ▇▇▇▇▇▇ +▇▇▇▇▇▇  ▇
▇  ▇▇▇▇▇▇  ▇▇▇▇▇▇  ▇
▇                  ▇
▇                  ▇
▇▇▇▇▇▇▇▇▇▇▇▇▇▇▇▇▇▇▇▇
